1111111111111
10010CC0C0CC1
100000C000001
1P0011E0000C1
1000111001111
1101000111011
1111111111111