1111111111111111111111111111111111
1E10000000000000000000000000000111
1010000000000000000000000000000111
1010000000000000000000000000000111
1PC0000000000000000000000000000111
1111111111111111111111111111111111